(5, 10) # .
#.........
.##.......
##........
..........
..........
